#====================================================================
#
# 氷初期配置情報[ice_stage_title.txt]
# Author：Soma Ishihara
#
#====================================================================
# 0:なし , 1:通常氷 , 2:硬い氷
#====================================================================

SETICE

 0 0 0 0 0 0 0 0 0 0 0 1 0 0 0
0 0 1 1 0 0 0 0 0 0 0 1 1 1 0
 0 1 2 0 0 0 0 0 0 0 0 1 2 0 0
0 0 1 0 0 0 0 0 0 0 0 0 0 1 0
 0 0 0 0 0 0 1 1 0 0 0 0 0 0 0
0 0 0 0 0 0 1 1 1 0 0 0 0 0 0
 0 0 0 0 1 1 1 1 1 1 0 0 0 0 0
0 0 0 0 1 1 1 2 1 1 1 0 0 0 0
 0 0 0 0 1 1 1 1 1 1 0 0 0 0 0
0 2 0 0 0 0 1 1 1 0 0 0 0 0 0
 0 0 0 0 0 0 1 1 0 0 0 0 0 0 0
0 0 0 1 0 0 0 0 0 0 1 1 0 0 0
 0 0 2 1 0 0 0 0 0 0 1 1 1 0 0
0 0 0 0 1 1 0 0 0 0 2 0 0 1 0
 0 0 0 0 0 0 0 0 0 0 0 0 0 0 0

END_SETICE